
SO               ./textures/wall70x70.xpm



EA        ./textures/floor70x70_1.xpm
C               141,229,249


NO         ./textures/tacos70x70.xpm
F    151,155,166
WE ./textures/player_hack70x70_1.xpm

1111111111111
1000000000001
1000000000001
1000011100001
10001   10001
1000011100001
1000000000001
100000W000001
1111111111111
